8  7  6  5  4  5  6  7  8  9
9  0  0  0  3  0  0  0  0  10
10 0  99 99 2  99 99 99 0  11
11 0  99 0  1  0  0  99 0  12
12 0  99 0  0  0  0  99 0  13
13 0  99 0  0  0  0  99 0  12
12 0  99 0  0  1  0  99 0  11
11 0  99 99 99 2  99 99 0  10
10 0  0  0  0  3  0  0  0  9
9  8  7  6  5  4  5  6  7  8
