0  0  0  0  0  0  0  0  13 0
0  0  11 10 9  8  0  0  12 0
14 13 12 0  0  7  0  0  11 0
0  10 0  99 99 6  99 0  10 9
0  9  99 99 0  5  99 99 0  8
7  8  99 0  0  4  0  99 6  7
6  0  99 0  2  3  0  99 5  0
5  99 99 0  1  0  2  3  4  0
4  3  2  1  0  0  1  99 99 0
0  99 0  0  0  0  0  0  99 0
