0  0 0 0  0  0  0  0  0  0
0  0 0  0  0  0  0  0  0  0
0  0 0  0  0  0  0  0  0  1
0  0 0  0  0  0  0  0  0  2
21 20 19  0  0 0 0 0  0  3
0  0  18 0 0  0  0  0  7
0  0  17 0  0  0  0  0  0  8
0  0  16 15  14  13  12  11  10  9
0  0  0 0  0  0  0  0  0  0
0  0  0 0 0 0 0 0 0  0
