0  11 10 9  8  0  0  0  0  0
0  12 0  0  7  0  0  0  0  0
0  13 0  0  6  5  4  3  2  1
0  14 0  0  0  0  0  0  0  2
21 20 0  0  12 11 10 0  0  3
21 20 19 14 13 0  9  0  0  4
0  0  18 0  0  0  8  7  6  5
0  0  17 0  0  0  0  0  0  6
0  0  16 0  0  0  0  0  0  7
0  0  15 14 13 12 11 10 9  8
