 0 6 7 8 9 0 0 0 0 0
 0 5 0 0 10 0 0 0 0 0
 0 4 0 0 11 12 13 14 15 22
 0 3 0 0 0 0 0 0 0 21
 1 2 0 0 7 8 9 0 0 20
 1 3 4 5 6 0 10 0 0 19
 0 0 5 0 0 0 11 12 13 18
 0 0 6 0 0 0 0 0 0 17
 0 0 7 0 0 0 0 0 0 16
 0 0 8 9 10 11 12 13 14 15